date,revenue,expenses,profit,cashflow,demand
2023-01-01,10000,6000,4000,2000,500
2023-02-01,12000,6500,5500,2500,550
2023-03-01,15000,7000,8000,3000,600
2023-04-01,13000,6800,6200,2800,580
2023-05-01,14000,7200,6800,3200,620
2023-06-01,16000,7500,8500,3500,650
2023-07-01,17000,8000,9000,4000,700
2023-08-01,18000,8500,9500,4200,720
2023-09-01,19000,9000,10000,4500,750
2023-10-01,20000,9500,10500,4800,780
2023-11-01,22000,10000,12000,5000,800
2023-12-01,25000,11000,14000,5500,850
